╔╦╦╣╠╦╦╗
╠╬╣╚╣╬╠╣
╠╣╚╬╦╣╬╣
╚╬╦╣╬╩╣╩
╠╣╬╬╦╩╣╩
╠╣╩╠╬╣╬╣
╠╬╣╬╣╦╣╩
╚╩╠╩╬╣╬╝